NO ./assets/NO.xpm
SO ./assets/SO.xpm
WE ./assets/WE.xpm 
EA ./assets/EA.xpm
F 255, 0, 0 
C 255, 0, 0

1111111111111111111111 11111111111111111111111111111111111111111111111111111111
1111111111111111111001 10010000000000000000010000000000000000000100000000000001
1111000001000000001001110010000000000000000010000000000000000000100000000000001
 100000000000100001000000011000000011111100111000000000000000001100000000000111
11000000000001000010000000010000000100001000100000000000000000010000000000001
11111111111111111111111111111111111100000111111111111111111111111111111111111
10000000000000000010000000000000000000000001000000000000000000000000000000011
11100000000000000010000000000000011100001111100000000000000000000000000000001
  1000000000000000100W0000000000010000001  100000000000000000000000000000001
  100000000000000010000000000000000000001  100000000000000000000000000000001
  111111111111111111111111111111111111111  111111111111111111111111111111111
