NO ./assets/NO.xpm
SO ./assets/SO.xpm
WE ./assets/WE.xpm 
EA ./assets/EA.xpm
F 255, 0, 0 
C 255, 0, 0

111111111111111111111111111111111111111111111111
100000000000000000000000000000000000000000000001
111111111111111111111111111111111111111111111111
100000000000000000000000000000000000000000000001
111111111111111111111111111111111111111111111111
100000000000000000000000000000000000000000000001
111111111111111111111111111111111111111111111111
100000000000000000000000000000000000000000000001
111111111111111111111111111111111111111111111111
100000000000000000000000000000000000000000000001
111111111111111111111111111111111111111111111111
100000000000000000000000000000000000000000000001
111111111111111111111111111111111111111111111111
100000000000000000000000000000000000000000000001
111111111111111111111111111111111111111111111111
100000000000000000000000000000000000000000000001
111111111111111111111111111111111111111111111111
100000000000000000000000000000000000000000000001
100000000000000000000000000000000000000000000001
100000000000000000000000000000000000000000000001
100000000000000000000000000000000000000000000001
100000000000000000000000N00000000000000000000001
111111111111111111111111111111111111111111111111
