NO ./assets/NO.xpm
SO ./assets/SO.xpm
WE ./assets/WE.xpm 
EA ./assets/EA.xpm
F 255, 0, 0 
C 255, 0, 0

11111111
10001001
1E001001
11111111