NO ./assets/NO.xpm
 SO ./assets/SO.xpm
 C 255, 0, 0
WE ./assets/WE.xpm 
EA ./assets/EA.xpm
F 255, 0, 0 

1111111111111111111111111111111111111111111111111111111111111111111111111111111
1000000000000000000000000010000000000000000000000000000000000000100000000000001
1100000000000000000000000010000000000000000010000000000000000000100000000000001
 100000000000000000000000011000000000000000111000000000000000001100000000000111
11000000000000000000000000010000000000000000100000000000000000010000000000001
100000000001000000000000000000000000N0000000000000000000000000010000000000001
10000000000000000000000000000000000000000000000000000000000000000000000000011
1110000000000000000000000000000001110000000000000000000000000000000000000001
  10000000000000000000000000000001000000000000000000000000000000000000000001
  10000000000000000000000000000000000000000000000000000000000000000000000001
  11111111111111111111111111111111111111111111111111111111111111111111111111
