NO ./path_to_the_north_texture
SO ./path_to_the_south_texture
WE ./path_to_the_west_texture
EA ./path_to_the_east_texture

C 255,0,0
F 0,0,0

111111111111
1000W0000001
100000000001
111111111111
